###################
#===============@=#
#====#====&===#===#
#===#=@=======#===#
#========&====#===#
#=========#=@=#===#
#====@=====@==#===#
#======#======#===#
#===@=##===@==#===#
###################